################## #
#     #        #   #
# ### ####### ### ##
# #   #       #    #
# ##### ##### # ####
#   #     #        #
# ### ### ##### ####
#   # #     #      #
##### ### ######## #
#     #   #        #
## ## ### ###### ###
#         #        #
##### ##### ### ####
#         #   #    #
####### ### ### ####
#     #   #        #
##### ### ##### ####
#       #     # #  #
#  ##      #       #
####################