################## #
# #        #       #
# # ### #### #######
#   #   # #   # #  #
# ### ### # # #    #
#   #     # #   #  #
### ##### # ### ## #
#     #   # #      #
# ### # ### # ###  #
# #           #    #
# # # ### # # #### #
# #   # #          #
# # # # # # ########
# # # # #   #  #   #
# # # # # # #  #   #
# ##### # # # #  # #
# # #     #   #    #
# # # ### ### # ## #
#       #   # #    #
####################