################## #
# #           #    #
# # ### # # # # ####
#   # # # #   # #  #
# # # # # ##### #  #
# #   # # #   # # ##
# #  ## # # # # #  #
# ##    #   #      #
# # # # ### ## ### #
### # # # # #   # ##
#       #          #
# # # ### # # ##  ##
#   # #   #   #    #
### # # # # ## ##  #
# #       #        #
# ### # # # ##### ##
#   # #   #     #  #
# # # # # # ##### ##
# #   # #   #      #
####################