################## #
#         #        #
# ####### ### ### ##
#       #       #  #
##### # ## #### ####
#   # #    #       #
# ### # #### #######
# #       #        #
# ## #### ### #### #
#     #   #        #
##### ##### ### ####
#         #        #
# ########### #### #
# #       #        #
# # ##### ##### ####
#       #     #    #
# ##### ####### ####
# ####     #     # #
#    #             #
####################