################## #
#   #   #          #
# # # ###  ### #####
# # #   #    #     #
# # ### # #  ### # #
# #       #      # #
# # # ### ##### #  #
#    ##### #       #
# ### # #  ### # ###
#     #   # #      #
#   #   # # #  # # #
# ### ##### # #### #
# #         #      #
# # ### ###  ### ###
# # #   # # #      #
# # # # # # #### ###
# # #   #      # # #
# # ### ### #  # # #
#         #        #
####################