################## #
#   # #   #   #    #
# # # ###   ### ## #
# # #      #     # #
# # # ##### ### #  #
# #           #    #
### ### #########  #
#        ###       #
# ##### # ### ###  #
# #        #   # # #
#   #   #          #
# ### ### # ### ####
#  #   #  # # #    #
####### ### # #  ###
#     # #     #    #
# # # # # #####  # #
# # #     #   #  # #
### ### #  # ##### #
#   #   #    #     #
####################