################## #
#         #        #
# ### ### ### # #  #
#   # # # # #   #  #
# # # # # # # # #  #
# # # #     # #    #
### ### # ### # ####
#   #   #          #
# # # ### ### ###  #
# # #   # #   # #  #
### # # # # #   #  #
#   #   #   # ######
### ### # ### ###  #
#   # # # #   #    #
# ### # # # ### ## #
#  #         ##    #
#     # # #        #
### ### # ### ###  #
#   #     #        #
####################