################## #
#     #   #        #
# ##### ### # ###  #
#   # # #   # # # ##
# # # # # # # # #  #
#   #         #    #
## ## ### ##### ####
#   # # #          #
# ### # ### # ## # #
# #     # #     #  #
# # # # # # ### ####
#   # #     #   #  #
### ##### ### # #  #
# #   #   #       ##
# # # # # # ### #  #
# # # # # #   # #  #
#       #   # #    #
### ### # # # # #  #
#     #   #     #  #
####################