################## #
#         ##   #   #
# ### # # ### #  # #
#   #   # ###    # #
# # #  #   # # # # #
#   # # #    # # # #
# # ### # #  # # ###
#       #          #
# # # ### ###  ### #
# # #   #  #   # # #
###    ##   #  # # #
#   #   #   # #    #
### ### # ###  ### #
#   # #    #   #   #
# ### # ###    # ###
#  #          ##   #
#     # # #        #
### # # #  ####  # #
#   #      #       #
####################