################## #
#       #       #  #
# # ### # # ### #  #
#   # # # #   #    #
# # # # # # ### #  #
# #   # # #   # ####
# # ###  # # #  #  #
#   #       #      #
# # # # ### #### ###
# # # # # # # #    #
### # ##  # # # ## #
#         # #   #  #
#   # #   #   #    #
### # # ### ### ## #
# #     # #        #
# ### # # # #####  #
#   # #   #     #  #
# # # # # # #####  #
# #   # #   #      #
####################
